111111111111111111111111111111111
100E00000011000E0111E111111111111
100000000E00000E00000000000E000E1
1000E000000000E000E000000000000E1
1000000C000E000000000000000E00001
100E0000000000E0000000P0000000001
111111111111111111111111111111111