111111111111111111111111111111111
10000000001100000111E111111111111
1000P0000000000000000000000000001
10000P0000P000P000000000000000001
100000PC0000000000P00000000P00001
1000000P0000000000000P00000000001
111111111111111111111111111111111