111111111111111111111111111111111
10000C00001100000111E111111111111
1000000000C000000000000000C000001
100C000000000C0000000000000000001
10000C00C000000000000000000C00001
10C0C00C00CCC00C000000P0000000001
111111111111111111111111111111111